00 00 00 00 00 00 00 00
00 00 00 00 00 00 00 00
00 00 00 00 00 00 00 00
00 00 00 00 00 00 00 00
00 00 00 00 00 00 00 00
9a 19 40 00 00 00 00 00
37 19 40 00 00 00 00 00
46 19 40 00 00 00 00 00
48 00 00 00 00 00 00 00
24 0e 40 00 00 00 00 00
78 24 40 00 00 00 00 00
80 24 40 00 00 00 00 00
71 19 40 00 00 00 00 00
37 19 40 00 00 00 00 00
a7 18 40 00 00 00 00 00
35 66 66 37 36 32 66 39 00
