00 00 00 00 00 00 00 00
00 00 00 00 00 00 00 00
00 00 00 00 00 00 00 00
00 00 00 00 00 00 00 00
00 00 00 00 00 00 00 00
a7 19 40 00 00 00 00 00
37 19 40 00 00 00 00 00
46 19 40 00 00 00 00 00
48 00 00 00 00 00 00 00
c3 19 40 00 00 00 00 00
ef 19 40 00 00 00 00 00
33 1a 40 00 00 00 00 00
71 19 40 00 00 00 00 00
37 19 40 00 00 00 00 00
a7 18 40 00 00 00 00 00
35 66 66 37 36 32 66 39 00
